11111111111111111111111111111
10001010100000000010100010101
10101010101010111010101110101
10100000001010101000100010001
11101110101110101010111010101
10101000100010101010100000101
10111011111010101110111010111
10000000001010001000001010101
10101110111011101011101110101
10100010100010101000100000101
10111110101110111110111110101
10100000101010100000001000001
10111111101010101111111010101
10000010001000000010100010101
10111010101010101110111011101
10100010101010100000100010001
10111010111110111011101111101
10101000000010100000100010001
10101110101110111011101011101
10001000101000100010001010001
10111010111011111010101110101
10100010000000000000100000101
10101110101011111110111111101
10100010101000100000000010101
10111111101111111110101010101
10000000001000000000101010001
11111010101010101110101011101
10000010100010101000101010001
11111111111111111111111111111
